11111111111
10C100000E1
10010001101
10010010001
10001100011
10011000001
1C010001001
10100010001
1P001101101
10000010001
11111111111