11111111111
1P000C0CE01
10101010001
10100011101
101110101C1
10001C00011
10011000101
1C0110C0101
1010C010001
10111010101
1000110C011
11111111111