1111111111
1110001101
1110010001
1001111001
1001001101
1001C00101
1001000101
1000100101
1001110101
1P0C00E001
1111111111