1111111111111
10C10000000C1
100001110C001
1P0C01E000001
1111111111111
1101101000111
1101101111011
1110001000011
1111101011111
1111101100011
1111111111111
1111111111111