11111111111
1P011100001
10100010001
10100010001
10100C10101
10100010001
10111111101
10000000101
10100101101
1010000E001
11111111111