111111111
1C0C001E1
101010101
1C1000C01
101010101
1C1000C01
101010101
1C1000C01
101010101
1P1000001
111111111