11111111111
11110C01111
11110111111
11110001111
11110001111
10000000001
1C000P00001
10000000001
11110001111
11110111111
11110E11111
11111111111